121111111111111
144444444444441
101010111111141
100010000000141
101011111111141
101000001444441
101111101411111
100010001414441
111010111414141
100010101444141
101110101111141
101000100014441
101011111014111
101000000014441
111111111111131
