121111111111111
144400100000101
101410111110101
100410100000101
101410101111101
101410101000101
111410101010101
144410001010001
141011111011111
141000001000001
141111111111101
144444144400001
101114141411111
100014441444443
111111111111111
