121111111111111111111111
100000000000100000000000
101011101110101111101110
101000100010001000101000
101110101011111110111010
100000101000000010100010
101111101111111010101111
100000100000001000100000
101110111111101111101110
100010001000101000100010
111011111011101010111010
101010001000001010001010
101010101111111011101010
101010101000001000101010
101010101011101110101110
100010100010001000101000
101110101110101011101011
101000101000101010001000
111011111011111010111110
100010000010000010000010
101110101110101111111010
100010100010101000100010
111010111110101010101110
100010000000100010100003
