111111111111111
240000000000101
141111101110101
140000100010101
141010111110101
141010000000101
141011101111101
141000101000001
141110101010111
141000101010001
141011111011111
141000000014441
141111111114141
144444444444143
111111111111111
